11111111111111111111
10000000000000000001
10000000000000100001
10000000000000100001
10000000000000100001
10000000000000100001
10000000000000100001
10001111111111100001
10000000000000000001
10000000000000000001
10000000000000000001
10000000000000000001
10000000000000000001
10000000000000000001
11111111111111111111